-------------------------------------------------
-                                               -
-                                               -
-                                               -
-   --------------------------------------      -
-   -                                           -
-   -                                           -
-   -   -                               -   -   -
-   -   ---------------------------------   -   -
-   -   -                                   -   -
-   -   -                                   -   -
- - -   -     ---------------------------   -   -
-   -   -                               -       -
-   -   -                               -       -
-   -   ---------------------------     -   -   -
-   -   -                               -   -   -
-   -   -                               -   -   -
-       -     ---------------------------   -   -
-                                           -   -
-   -                                           -
-   -   ---------------------------     -       -
-   -   -                               -   -   -
-   -   -                               -   -   -
-   -   -     ---------------------------   -   -
-       -                               -   -   -
-       -                               -   -   -
-   -   ---------------------------     -   - - -
-   -                                   -   -   -
-   -                                   -   -   -
-   -   ---------------------------------   -   -
-   -   -                               -   -   -
-                                           -   -
-                                           -   -
-      --------------------------------------   -
-                                               -
-                                               -
-                                               -
-------------------------------------------------